02,02,02,02,02,02,02,02,02,02,02
02,00,01,00,01,03,01,00,01,00,02
02,10,11,10,11,10,11,10,11,10,02
02,00,01,00,01,00,01,00,01,00,02
02,10,11,10,11,10,11,10,11,10,02
02,00,01,00,01,00,01,00,01,00,02
02,10,11,10,11,10,11,10,11,10,02
02,00,01,00,01,00,01,00,01,00,02
02,10,11,10,11,10,11,10,11,10,02
02,00,01,00,01,00,01,00,01,00,02
02,02,02,02,02,02,02,02,02,02,02